111111
100101
101001
110310
111111