NO   textures/north_wall.xpm

                SO                                                 textures/mossy.xpm
WE                                                textures/greystone.xpm
                                                              
                           EA  textures/colorstone.xpm   

      F   									79,84,82
   		C         	    		166,219,247   				     
					   
		1111111111111111111111111
        1000000000110000000000001
		1011000001110000000000001
		1001000000000001000000001
111111111011000001110000000000001
100000000011000001110111111111111
11110111111111011100000100011
11110111111111001101010010001
11000000110101011100000010001
10000000000000000000000000001
10000000000000001101010010001
1100000111010101111101111E00111
11110011 1110101 101111010001
11111111 1111111 111111111111



