				WE								  textures/north_wall.xpm 			


						SO 						textures/mossy.xpm				


	NO  	 	textures/greystone.xpm					
	


EA textures/colorstone.xpm       

      C   									2,155,2
   		F         	    		0,0,0   				     
		
					   
        111111111111111111111111111111111
111111111000000000110000000000001
111111111011000001110000000000001
111111111001E00000000000000000001
111111111011000001110000000000001
100000000011000001110111101111111
11110111111111011100000010001
11110111111111011101010010001
11000000110101011100000010001
10000000000000001100000010001
10000000000000001101010010001
1100000111010101110101101000111
11110111 1110101 101111010001
11111111 1111111 111111111111



