


NO   textures/north_wall.xpm

                SO                                                 textures/mossy.xpm
WE                                                textures/greystone.xpm
                                                              
                           EA  textures/colorstone.xpm     


    C 12,1,12
  F 2,155,2

111111111111111111111111
11111111111111000001000111
11111011111111000010101111111
11000000110101011100000010001
1001110000000000000000000001
1001110W00000000110101010001
110111011101010111110111100011
111111111111111111111111111111


 

















